                                                  
                                                
                         ##                       
          ###    #      ##                        
   #        P   ##     ##                        
   #   #       ###    ##                          
##### ############################################
##### ############################################
##################################################
##################################################
