#####                                                                                                                                  ####
#####                                                                                                                                  ####
#####                                                                                                                                  ####
#####                                                                                                                                  ####
#####                                                                                      @@                                          ####
##### @@            ****    ^^^  ***                                                                                                   ####
#############                                                                                                                          ####
##############              @#####                    @@                               ******         ####^^^^^@@                      ####
#####                      ##############^^^       ###########                           #######    ##############                     ####
#####              @ ^^^#################^^^       #######################                       #######                               ####      
#####          ########################                                  ##            ####                                            ####       
#####                                                                    ###                                                           ####
#####                                                         ******       ##############                 @ **                         ####     
#####       @ *****                                       ^^^^**      ###################            ###########                       ####         
#####    ############         ####################          ######################################                                     ####        
#####                                                      ##                                                                          ####
#####                 ######                                    ###                                                                    ####
##### P                        @ @                                                                                                     ####      
###########################################################################################################################################
###########################################################################################################################################
###########################################################################################################################################
###########################################################################################################################################



