#########                                                               ######### 
#########                                                               ######### 
#########                                                               #########  
#########                                @                              ######### 
#########                       @ ^^   ######                           ######### 
#########                   #################         ^^^ ##            ######### 
#########        ****^^                             @ *** ##            ######### 
#########       ###########              ^^^^#####################      ######### 
######### P                     *****       @                      @    ######### 
################################################################################# 