                                                  
                                                
           P             ##                       
          ###    #      ##                        
   #           ^##     ##                        
   #   #      *###    ##                          
##### ############################################
##### ############################################
##################################################
##################################################
