                                                  
                                                
           P             ##                       
          ###    #      ##                        
   #            ##     ##                        
   #   #       ###    ##                          
##### ############################################
##### ############################################
##################################################
##################################################
